.............................................
.............................................
.......................##########............
.......................##########............
......................###......####..........
......................###........####........
......................###..........####......
......................N##...........####.....
.....#####################################...
.....##################@##################...
.......................##....................
.......................##....................
.......................##....................
.......................##....................
.......................##....................
.............................................
.............................................